#################################################
#...............................................#
#...............................................#
#...............................................#
#...............................................#
#...o....................................a......#
#...............................................#	
#...............................................#
#...............................................#
#...............................................#
#...............................................#
#...............................................>
#...............................................>
#...............................................#
#...............................................#
#...............................................#
#...............................................#
#...............................................#
#...............................................#
#.@.............................................#
#...............................................#
#...............................................#
#...............................................#
#####################VV##########################
