#################################################
#...............................................#
#...............................................#
#...............................................#
#...............................................#
#...o....................................a......#
#...............................................#	
#...............................................#
#...............................................#
#...............................................#
#.................@.............................#
#...............................................#
#...............................................#
#...............................................#
#...............................................#
#...............................................#
#...............................................#
#...............................................#
#...............................................#
#...............................................#
#...............................................#
#...............................................#
#...............................................#
#################################################
